******
*E  E*
* U  *
*C G *
*GC G*
******
